决定			确定
すすむ		继续
もどる		返回
きりかえ		切换
おきにいり	我的最爱
けす			删除
せつめい		说明
スキっぷ		跳过
いどう		移动
ごうせい		合成
わかれる		分别
のうりょく	能力
ならびかえ	排序
はいち		配置
きせかえ		换装配件
からだ		身体
あたま		头部
いのち		生命值
スピード		速度(speed)
おそい		慢速
ふつう		普通
はやい		快速
こうげき		攻击
メンバ		成员(Member)

プレイ		play
デ一ダ		data
ベスト		best
すべて		全部
クリア		clear
クリア成功	演奏成功
チャレンジ	Challenge
チャレンジ成功	挑战成功
